11 13
F#.F#N#F#FN#N
F##.FNFNFNNN.
NNFFFFFFNFSFN
..NNFFFF.FNFN
NN.FN.NNNFFFF
#F##FFFEFNFFF
.NNF.FF#NN#FF
.FNF.NN#FFN#F
NFFFF#FNFFN.N
F#F###..N#FFF
NFFFNNFNFFFFN
