8 15
NN.............
NN.............
SN#E...........
NN.............
NN.............
...............
...............
...............