6 15
.......E.......
.......#.......
...............
.......S##.....
.......NE.#....
......FE##.....