6 10
....S#....
...###....
...#ENF...
#.####.###
....NF.#..
....FN.#.E