5 20
.............#..E...
...........#.N..E...
S...........FF..E...
...........#.F..E...
.............#..E...