20 20
NENNNNNNNNNNNNNNNNNN
NFFF...............N
NFN.NNNNNNNNNNNNNN.N
N.N.N............N.N
N.N.N.NNNNNNNNNN.N.N
N.N.N.N........N.N.N
N.N.N.N.NNNNNN.N.N.N
N.N.N.N.N....N.N.N.N
N.N.N.N.N.NN.N.N.N.N
N.N.N.N.N..N.N.N.N.N
N.N.N.N.N.SN.N.N.N.N
N.N.N.N.NNNN.N.N.N.N
N.N.N.N......N.N.N.N
N.N.N.NNNNNNNN.N.N.N
N.N.N..........N.N.N
N.N.NNNNNNNNNNNN.N.N
N.N..............N.N
N.NNNNNNNNNNNNNNNN.N
N..................N
NNNNNNNNNNNNNNNNNNNN