6 10
.FN.S#....
.NN###....
.NN#E#F...
#.####.##.
......N#..
.......#.E