20 20
#E##################
#.F................#
#.#.##############.#
#.#.N............#.#
#.#.#.##########.#.#
#.#.#.N........#.#.#
#.#.#.#.######.#.#.#
#.#.#.#.#....#.#.#.#
#.#.#.#.#.##.#.#.#.#
#.#.#.#.#..#.#.#.#.#
#.#.#.#.N.S#.#.#.#.#
#.#.#.#.####.#.#.#.#
#.#.#.#......#.#.#.#
#.#.#.########.#.#.#
#.#.#..........#.#.#
#.#.############.#.#
#.#..............#.#
#.################.#
#..................#
####################