6 10
.NN.S#....
.NN###....
.NN#E#....
#.####.###
.......#..
.........E
