6 10
....S#E...
...###....
F..#E.....
#N###..###
.......#..
.......#..
