20 20
NENNNNFNFNFNFNFNFNFN
F.FF...............N
FFN.FNFNFNFNFNFNFN.F
NNF.N............N.F
N.F.N.FNFNFNFNFN.F.N
FNN.F.N........N.F.N
F.N.F.N.FNFNFN.F.N.F
N.F.N.F.N....F.N.F.N
F.N.F.N.F.NF.N.F.N.F
N.F.N.F.N..F.N.F.N.F
N.F.N.F.N.SN.F.N.F.N
F.N.F.N.FNFN.F.N.F.N
F.N.F.N......F.N.F.N
F.N.F.NFNFNFNF.N.F.N
F.N.F..........N.F.N
F.N.FNFNFNFNFNFN.F.N
F.N..............F.N
F.NFNFNFNFNFNFNFNF.N
F..................N
FNFNFNFNFNFNFNFNFNFN