6 15
.......E.......
.......N.......
...............
.......S.......
.......FN......
.......E.......