6 10
.NF.S#....
FNN###....
.FF#E#....
#.####.###
.......NFN
.......#.E