5 9
.#E#...#S
..#.N#F#.
.#E#.#...
..#...###
.E......E