15 17
NFN##FNF.NEF.NNNF
F##FF#NNFF.FN##FF
.#FF#N#NFNNFFN#F.
#FNN.SNFFNFFFFNN#
FNFFN.FFFN.N.#.#F
N.FFFFNNN#FFFNN#.
FFFFFFF#NNFN.NF.N
FF#.FNNNNFNNFFNNF
NNNEFN###N.FFNNF#
FNNF##F#FNFNNFFFN
F###N#NNNNFNF.NNN
##FF.N.FF.FFFNNNF
FFFFNFFFNFFFFNNN.
.#FFNFF.FFFFN##FF
FNF.FFNNFFNN##N#.
