20 20
#E##################
#.#................#
#.#.##############.#
#.#.#............#.#
#.#.#.##########.#.#
#.#.#.#........#.#.#
#.#.#.#.######.#.#.#
#.#.#.#.#....#.#.#.#
#.#.#.#.#.##.#.#.#.#
#.#.#.#.#..#.#.#.#.#
#.#.#.#.#.S#.#.#.#.#
#.#.#.#.####.#.#.#.#
#.#.#.#......#.#.#.#
#.#.#.########.#.#.#
#.#.#..........#.#.#
#.#.############.#.#
#.#..............#.#
#.################.#
#..................#
####################