6 15
.......E.......
.......#.......
...............
.......S.......
.......##......
.......E.......