5 9
.#E#...#S
..#..#.#.
.#E#.#...
..#...###
.E......E