6 10
....S#....
...###....
...#E#....
#.####.###
.......#..
.......#.E
