5 20
................E...
...............#E...
S..............#E...
...............#E...
...............#E...