8 15
...............
##.............
S#E............
##.............
...............
...............
...............
...............